#####################################
#                                   #
# ### ############################# #
#   #                           # # #
### ##### ##################### # # #
#       #                     # # # #
# ####### ################### # # # #
# #     #                 # # # # # #
# # ##### ############### # # # # # #
# #                     # # # # # # #
# ##################### # # # # # # #
#                       # # # # #   #
######################### # # ##### #
#                         # #       #
# ####################### # ####### #
#                       # #         #
# ##################### # ###########
#                   # # #           #
# ################# # # ######### # #
#                 # # #         # # #
###################################@#
