##########
#        #
# ### ####
#   #    #
#### ### #
@        #
##########
