#########################################################
#                                                       #
# ##################### ############# ############# ### #
#                     #       #       #               # #
##### ############# ### ##### # ##### # ############# # #
#   #           #   #   #     #     #               #   #
# # ############# ### # # ######### # ############# ### #
# #             # #   # #         # # # #             # #
# ############# # ##### ######### # ### ############# # #
#               #     #           #                   # #
##### ########### ### ############# ############### ### #
#     #       #     #               #             #     #
# ### # ##### ##### ############### ############# ##### #
#   # #   # # #     #               #   #       # #     #
# ### ##### # ##### ############### ### # ##### # ##### #
#   #       #       #               #     #     #       #
##### ############### ############# ##### ##### #######
#     #       #     #               #     #     #       #
# ### # ##### # ### # ############# # ### # ##### #######
# #   #   #   # #   # #       #     # #   #   #   #     #
# # ##### # ### ##### ##### # ##### # ##### ##### ##### #
#   #     #             #   #     # #     #     #       #
### ####### ############# ### ##### ##### ######### ### #
#         #             #     #       #       #   # #   #
# ####### ##### ##### # ##### ##### # ##### # # # # # #
#         #       #     #   #     # #       # #     # # #
# ####### ### ##### ##### # ##### # ####### ######### # #
# #   #   #   #   #   #   #     # # #       #         # #
# # # ######### # # ##### ##### # # # ##### # ####### # #
# # #         # # #       #     # # #   #   # #     # # #
# # ######### # # ####### ####### # ##### ##### ### # # #
# #     #     #   #     #         #     #     #     #   #
#########################################################
